
▓▓▓▓▓▓▓▓▓▓▓▓▓▓▓▓▓▓▓▓▓▓▓▓▓▓▓▓▓▓▓▓▓▓▓▓▓▓▓▓
▓▓▓▓▓▓▓       ▓▓▓▓▓▓▓▓▓▓▓▓▓▓▓▓▓▓▓▓▓▓▓▓▓▓
►   ☻   ▓▓▓▓▓ ▓▓▓▓▓▓▓▓▓▓▓▓▓▓▓▓▓▓▓▓▓▓▓▓▓▓
▓▓▓▓▓▓▓▓▓▓▓▓▓                        ▓▓▓
▓▓▓▓▓▓▓▓▓▓▓▓▓ ▓▓▓▓▓▓▓▓▓▓▓▓▓▓ ▓▓▓▓▓▓▓ ▓▓▓
▓▓▓▓▓▓▓▓▓▓▓▓▓ ▓▓▓▓▓▓▓▓▓▓ ▓▓▓ ▓▓▓▓▓▓▓ ▓▓▓
▓▓▓▓▓▓▓▓▓▓▓▓▓ ▓▓▓▓▓▓▓▓           ▓▓▓ ▓▓▓
▓▓▓▓▓▓▓▓▓▓▓▓▓ ▓▓▓▓▓▓▓▓ ▓▓▓▓▓ ▓▓▓ ▓▓▓ ▓▓▓
▓▓▓           ▓▓▓▓▓▓▓▓ ▓▓▓▓▓ ▓▓▓ ▓▓▓ ▓▓▓
▓▓▓ ▓▓▓▓▓▓▓▓▓ ▓▓▓▓▓▓▓▓ ▓▓▓▓▓ ▓▓▓ ▓▓▓ ▓▓▓
▓▓▓ ▓▓▓▓▓▓▓▓▓      ▓▓▓           ▓▓▓ ▓▓▓
▓▓▓ ▓▓▓▓▓▓▓▓▓▓▓▓▓▓ ▓▓▓▓▓▓ ▓▓▓▓▓▓▓▓▓▓ ▓▓▓
▓▓▓ ▓▓▓▓▓▓▓▓▓▓▓▓▓▓ ▓▓▓▓▓▓▓▓▓▓▓▓▓▓▓▓▓ ▓▓▓
▓▓▓                ▓▓▓▓▓▓▓▓▓▓▓▓▓▓▓▓▓ ▓▓▓
▓▓▓▓▓▓▓▓▓▓▓▓▓▓▓▓▓▓ ▓▓▓▓▓▓▓▓▓▓▓▓▓▓▓▓▓ ▓▓▓
▓▓▓▓▓▓▓▓▓▓▓▓▓▓▓▓▓▓ ▓▓▓▓▓▓▓▓▓▓▓▓▓▓▓   ▓▓▓
▓▓▓▓▓▓▓▓▓▓▓▓▓▓▓▓▓▓ ▓▓▓▓▓▓▓▓        ▓▓▓▓▓
▓▓▓▓▓▓▓▓           ▓▓▓▓▓▓▓▓ ▓▓▓▓▓▓ ▓▓▓▓▓
▓▓▓▓▓▓▓▓ ▓▓▓▓▓▓▓▓▓▓▓▓▓▓▓▓▓▓ ▓▓▓▓▓▓ ▓▓▓▓▓
▓▓▓▓▓▓▓▓ ▓▓▓▓▓▓▓▓▓▓▓▓▓▓▓▓▓▓ ▓▓▓▓▓▓ ▓▓▓▓▓
▓▓▓▓▓▓▓▓                    ▓▓▓▓▓▓     ►      
▓▓▓▓▓▓▓▓▓▓▓▓▓▓▓▓▓▓▓▓▓▓▓▓▓▓▓▓▓▓▓▓▓▓▓▓▓▓▓▓
