
@@@@@@@@@@@@@@@@@@@@@@@@@@@@@@@@@@@@@@@@
@@@@@@@       @@@@@@@@@@@@@@@@@@@@@@@@@@
p       @@@@@ @@@@@@@@@@@@@@@@@@@@@@@@@@
@@@@@@@@@@@@@                        @@@
@@@@@@@@@@@@@ @@@@@@@@@@@@@@ @@@@@@@ @@@
@@@@@@@@@@@@@ @@@@@@@@@@ @@@ @@@@@@@ @@@
@@@@@@@@@@@@@ @@@@@@@@           @@@ @@@
@@@@@@@@@@@@@ @@@@@@@@ @@@@@ @@@ @@@ @@@
@@@           @@@@@@@@ @@@@@ @@@ @@@ @@@
@@@ @@@@@@@@@ @@@@@@@@ @@@@@ @@@ @@@ @@@
@@@ @@@@@@@@@      @@@           @@@ @@@
@@@ @@@@@@@@@@@@@@ @@@@@@ @@@@@@@@@@ @@@
@@@ @@@@@@@@@@@@@@ @@@@@@@@@@@@@@@@@ @@@
@@@                @@@@@@@@@@@@@@@@@ @@@
@@@@@@@@@@@@@@@@@@ @@@@@@@@@@@@@@@@@ @@@
@@@@@@@@@@@@@@@@@@ @@@@@@@@@@@@@@@   @@@
@@@@@@@@@@@@@@@@@@ @@@@@@@@        @@@@@
@@@@@@@@           @@@@@@@@ @@@@@@ @@@@@
@@@@@@@@ @@@@@@@@@@@@@@@@@@ @@@@@@ @@@@@
@@@@@@@@ @@@@@@@@@@@@@@@@@@ @@@@@@ @@@@@
@@@@@@@@                    @@@@@@     p 
@@@@@@@@@@@@@@@@@@@@@@@@@@@@@@@@@@@@@@@@
